{
	"tileset" : "mountain.png",
	"terrain" : [
		[15, 15, 15, 15, 15, 15, 16, 15, 31, 16, 15, 15, 15, 15, 15],
		[15, 16, 32, 15, 32, 15, 15, 15, 15, 15, 32, 15, 15, 15, 16],
		[32, 15, 15, 15, 15, 31, 32, 15, 15, 15, 16, 15, 31, 15, 31],
		[16, 15, 15, 31, 15, 15, 31, 15, 15, 15, 15, 15, 32, 15, 15],
		[15, 15, 15, 15, 15, 15, 31, 32, 16, 15, 15, 15, 16, 15, 15],
		[15, 15, 15, 15, 16, 15, 15, 32, 32, 31, 15, 15, 15, 15, 16],
		[32, 31, 15, 32, 15, 32, 15, 15, 16, 15, 31, 15, 15, 15, 31],
		[15, 15, 16, 15, 32, 15, 32, 31, 15, 15, 32, 15, 15, 15, 15],
		[15, 15, 15, 32, 15, 15, 15, 15, 15, 31, 15, 15, 31, 16, 15],
		[31, 15, 15, 31, 15, 16, 15, 15, 32, 15, 16, 15, 15, 15, 31],
		[16, 15, 15, 32, 16, 32, 15, 15, 15, 15, 15, 15, 15, 15, 16],
		[15, 16, 15, 16, 16, 15, 15, 15, 15, 31, 15, 15, 15, 15, 15],
		[32, 15, 15, 15, 31, 32, 15, 15, 16, 15, 15, 16, 32, 15, 31],
		[32, 15, 31, 15, 15, 15, 15, 15, 15, 15, 15, 15, 15, 15, 15],
		[15, 15, 15, 15, 16, 15, 16, 15, 15, 16, 15, 15, 15, 32, 32]
	]
}
